08 08 08 08 08 08 08 08 08 08 08 08 08 08 08 08 08 08 08 08 08 08 08 08 08
08 01 01 01 08 16 16 16 16 16 08 01 01 01 08 16 16 16 08 01 01 01 16 16 08
08 01 01 01 08 16 08 08 08 16 08 01 01 01 08 08 08 16 08 01 01 01 08 16 08
08 01 01 01 16 16 16 16 08 16 16 16 16 16 08 16 16 16 08 01 01 01 08 16 08
08 08 08 08 08 08 08 16 08 08 08 08 08 16 08 16 08 08 08 08 08 08 08 16 08
08 16 16 16 16 16 08 16 08 16 16 16 08 16 08 16 08 16 16 16 16 16 08 16 08
08 16 08 08 08 16 08 16 08 16 08 16 08 16 08 16 08 16 08 08 08 16 08 16 08
08 16 08 01 01 16 16 16 08 16 08 16 16 16 16 16 16 16 01 01 08 16 16 16 08
08 16 08 01 01 08 08 08 08 16 08 08 08 08 08 08 08 08 01 01 08 08 08 16 08
08 16 08 01 01 16 16 16 16 16 16 16 16 16 16 16 16 16 01 01 16 16 16 16 08
08 16 08 08 08 08 08 16 08 08 08 08 08 16 08 08 08 08 08 08 08 08 08 16 08
08 16 16 16 16 16 08 16 08 01 01 01 08 16 08 01 01 01 08 16 16 16 08 16 08
08 08 08 08 08 16 08 16 08 01 01 01 08 16 08 01 01 01 08 16 08 16 08 16 08
08 16 16 16 08 16 08 16 08 01 01 01 16 16 16 01 01 01 08 16 08 16 08 16 08
08 16 08 16 08 16 08 16 08 08 08 08 08 08 08 08 08 08 08 16 08 16 08 16 08
08 16 08 16 16 16 08 16 16 16 16 16 16 16 16 16 16 16 16 16 08 16 16 16 08
08 16 08 08 08 08 08 08 08 08 08 16 08 08 08 08 08 08 08 08 08 08 08 16 08
08 16 16 16 16 16 16 16 16 08 01 01 01 08 16 16 16 16 16 16 16 16 08 16 08
08 08 08 08 08 08 08 08 16 08 01 01 01 08 16 08 08 08 08 08 08 16 08 16 08
08 01 01 01 16 16 16 08 16 08 01 01 01 08 16 08 01 01 01 16 16 16 08 16 08
08 01 01 01 08 08 16 08 16 08 08 08 08 08 16 08 01 01 01 08 08 08 08 16 08
08 01 01 01 08 16 16 08 16 16 16 16 16 16 16 08 01 01 01 08 16 16 16 16 08
08 08 08 08 08 16 08 08 08 08 08 08 08 08 08 08 08 08 08 08 16 08 08 08 08
08 16 16 16 16 16 16 16 16 16 16 16 16 16 16 16 16 16 16 16 16 16 16 16 08
08 08 08 08 08 08 08 08 08 08 08 08 08 08 08 08 08 08 08 08 08 08 08 08 08