02 02 02 02 02 02 02 02 02 02 02 02 02 02 02 02 02 02 02 02 02 02 02 02 02
02 06 06 06 06 06 02 05 05 05 02 06 06 06 02 05 05 05 02 06 06 06 06 06 02
02 06 02 02 02 06 02 05 05 05 02 06 02 06 02 05 05 05 02 06 02 02 02 06 02
02 06 02 05 02 06 02 05 05 05 02 06 02 06 02 05 05 05 02 06 02 05 02 06 02
02 06 02 05 02 06 02 02 06 02 02 06 02 06 02 02 06 02 02 06 02 05 02 06 02
02 06 02 02 02 06 06 06 06 06 06 06 02 06 06 06 06 06 06 06 02 02 02 06 02
02 06 06 06 06 06 02 02 02 02 02 02 02 02 02 02 02 02 02 06 06 06 06 06 02
02 02 02 02 02 06 02 05 05 05 05 05 05 05 05 05 05 05 02 06 02 02 02 02 02
02 05 05 05 02 06 02 05 05 05 05 05 05 05 05 05 05 05 02 06 02 05 05 05 02
02 05 05 05 02 06 02 05 05 05 02 02 06 02 02 05 05 05 02 06 02 05 05 05 02
02 05 05 05 02 06 02 05 05 05 02 06 06 06 02 05 05 05 02 06 02 05 05 05 02
02 02 06 02 02 06 02 05 05 05 02 06 02 06 02 05 05 05 02 06 02 02 06 02 02
02 06 06 06 06 06 02 05 05 05 02 06 02 06 02 05 05 05 02 06 06 06 06 06 02
02 02 06 02 02 06 02 02 02 02 02 06 02 06 02 02 02 02 02 06 02 02 06 02 02
02 05 05 05 02 06 06 06 06 06 06 06 02 06 06 06 06 06 06 06 02 05 05 05 02
02 05 05 05 02 02 02 02 02 02 02 02 02 02 02 02 02 02 02 02 02 05 05 05 02
02 05 05 05 05 05 05 05 02 05 05 05 02 05 05 05 02 05 05 05 05 05 05 05 02
02 02 02 02 02 02 02 05 02 05 05 05 02 05 05 05 02 05 02 02 02 02 02 02 02
02 06 06 06 06 06 02 05 02 02 02 06 02 06 02 02 02 05 02 06 06 06 06 06 02
02 06 02 02 02 06 02 05 05 05 02 06 02 06 02 05 05 05 02 06 02 02 02 06 02
02 06 02 05 02 06 02 05 05 05 02 06 06 06 02 05 05 05 02 06 02 05 02 06 02
02 06 02 05 02 06 02 05 05 05 02 02 02 02 02 05 05 05 02 06 02 05 02 06 02
02 06 02 02 02 06 02 05 05 05 05 05 05 05 05 05 05 05 02 06 02 02 02 06 02
02 06 06 06 06 06 02 02 02 02 02 02 02 02 02 02 02 02 02 06 06 06 06 06 02
02 02 02 02 02 02 02 02 02 02 02 02 02 02 02 02 02 02 02 02 02 02 02 02 02