2 2 2 2 2 2 2 2 2 2 2 2 2 2 2 2 2 2 2 2 2 2 2 2 2
2 6 6 6 6 6 2 5 5 5 2 6 6 6 2 5 5 5 2 6 6 6 6 6 2
2 6 2 2 2 6 2 5 5 5 2 6 2 6 2 5 5 5 2 6 2 2 2 6 2
2 6 2 5 2 6 2 5 5 5 2 6 2 6 2 5 5 5 2 6 2 5 2 6 2
2 6 2 5 2 6 2 2 6 2 2 6 2 6 2 2 6 2 2 6 2 5 2 6 2
2 6 2 2 2 6 6 6 6 6 6 6 2 6 6 6 6 6 6 6 2 2 2 6 2
2 6 6 6 6 6 2 2 2 2 2 2 2 2 2 2 2 2 2 6 6 6 6 6 2
2 2 2 2 2 6 2 5 5 5 5 5 5 5 5 5 5 5 2 6 2 2 2 2 2
2 5 5 5 2 6 2 5 5 5 5 5 5 5 5 5 5 5 2 6 2 5 5 5 2
2 5 5 5 2 6 2 5 5 5 2 2 6 2 2 5 5 5 2 6 2 5 5 5 2
2 5 5 5 2 6 2 5 5 5 2 6 6 6 2 5 5 5 2 6 2 5 5 5 2
2 2 6 2 2 6 2 5 5 5 2 6 2 6 2 5 5 5 2 6 2 2 6 2 2
2 6 6 6 6 6 2 5 5 5 2 6 2 6 2 5 5 5 2 6 6 6 6 6 2
2 2 6 2 2 6 2 2 2 2 2 6 2 6 2 2 2 2 2 6 2 2 6 2 2
2 5 5 5 2 6 6 6 6 6 6 6 2 6 6 6 6 6 6 6 2 5 5 5 2
2 5 5 5 2 2 2 2 2 2 2 2 2 2 2 2 2 2 2 2 2 5 5 5 2
2 5 5 5 5 5 5 5 2 5 5 5 2 5 5 5 2 5 5 5 5 5 5 5 2
2 2 2 2 2 2 2 5 2 5 5 5 2 5 5 5 2 5 2 2 2 2 2 2 2
2 6 6 6 6 6 2 5 2 2 2 6 2 6 2 2 2 5 2 6 6 6 6 6 2
2 6 2 2 2 6 2 5 5 5 2 6 2 6 2 5 5 5 2 6 2 2 2 6 2
2 6 2 5 2 6 2 5 5 5 2 6 6 6 2 5 5 5 2 6 2 5 2 6 2
2 6 2 5 2 6 2 5 5 5 2 2 2 2 2 5 5 5 2 6 2 5 2 6 2
2 6 2 2 2 6 2 5 5 5 5 5 5 5 5 5 5 5 2 6 2 2 2 6 2
2 6 6 6 6 6 2 2 2 2 2 2 2 2 2 2 2 2 2 6 6 6 6 6 2
2 2 2 2 2 2 2 2 2 2 2 2 2 2 2 2 2 2 2 2 2 2 2 2 2