19 19 19 19 19 19 19 19 19 19 19 19 19 19 19 19 19 19 19 19 19 19 19 19 19
19 09 09 09 09 09 09 09 09 09 09 09 19 19 19 09 09 09 09 09 09 09 09 09 19
19 09 10 10 10 10 10 09 09 09 09 09 19 00 19 09 09 09 09 09 10 10 10 09 19
19 09 10 00 00 00 10 09 09 19 19 09 19 09 19 09 19 19 09 09 10 00 10 09 19
19 09 10 00 10 00 10 09 09 19 00 09 09 09 09 09 00 19 09 09 10 00 10 09 19
19 09 10 10 10 10 10 09 09 19 09 09 00 00 00 09 09 19 09 09 10 10 10 09 19
19 09 09 09 09 09 09 09 09 19 19 09 00 09 00 09 19 19 09 09 09 09 09 09 19
19 09 09 00 00 00 09 09 09 09 09 09 00 00 00 09 09 09 09 09 00 00 00 09 19
19 09 09 00 10 00 09 10 10 10 10 10 10 10 10 10 10 10 09 09 00 10 00 09 19
19 19 19 00 10 00 09 10 09 09 09 09 09 09 09 09 09 10 09 09 00 10 00 19 19
19 19 00 09 10 09 09 10 09 19 19 19 00 19 19 19 09 10 09 09 09 10 09 00 19
19 19 09 09 10 09 09 10 09 19 09 09 09 09 09 19 09 10 09 09 09 10 09 09 19
19 19 09 09 10 09 09 10 09 19 09 10 10 10 09 19 09 10 09 09 09 10 09 09 19
19 19 09 09 10 09 09 10 09 19 09 10 00 10 09 19 09 10 09 09 09 10 09 09 19
19 19 00 09 10 09 09 10 09 19 09 10 10 10 09 19 09 10 09 09 09 10 09 00 19
19 19 19 00 10 00 09 10 09 19 19 19 09 19 19 19 09 10 09 09 00 10 00 19 19
19 09 09 00 10 00 09 10 09 09 09 09 09 09 09 09 09 10 09 09 00 10 00 09 19
19 09 09 00 10 00 09 10 10 10 10 10 10 10 10 10 10 10 09 09 00 10 00 09 19
19 09 09 00 00 00 09 09 09 09 09 09 00 00 00 09 09 09 09 09 00 00 00 09 19
19 09 09 09 09 09 09 09 09 19 19 09 00 09 00 09 19 19 09 09 09 09 09 09 19
19 09 10 10 10 10 10 09 09 19 09 09 00 00 00 09 09 19 09 09 10 10 10 09 19
19 09 10 00 10 00 10 09 09 19 00 09 09 09 09 09 00 19 09 09 10 00 10 09 19
19 09 10 00 00 00 10 09 09 19 19 09 19 09 19 09 19 19 09 09 10 00 10 09 19
19 09 10 10 10 10 10 09 09 09 09 09 19 00 19 09 09 09 09 09 10 10 10 09 19
19 19 19 19 19 19 19 19 19 19 19 19 19 19 19 19 19 19 19 19 19 19 19 19 19