14 14 14 14 14 14 14 14 14 14 14 14 14 14 14 14 14 14 14 14 14 14 14 14 14
14 13 13 13 11 11 04 04 04 14 13 13 13 13 13 14 04 04 04 11 11 13 13 13 14
14 13 14 13 11 11 04 04 04 14 13 14 14 14 13 14 04 04 04 11 11 13 14 13 14
14 13 14 13 14 14 04 04 04 14 13 14 04 14 13 14 04 04 04 14 14 13 14 13 14
14 13 14 13 13 13 13 14 14 14 13 14 04 14 13 14 14 14 13 13 13 13 14 13 14
14 13 14 14 14 14 13 13 13 13 13 14 04 14 13 13 13 13 13 14 14 14 14 13 14
14 13 13 13 13 14 14 14 14 14 14 14 13 14 14 14 14 14 14 14 13 13 13 13 14
14 14 14 14 13 14 04 04 04 04 04 04 04 04 04 04 04 04 14 13 13 14 14 14 14
14 04 04 04 13 14 04 04 04 04 04 04 04 04 04 04 04 04 14 13 04 04 04 14 14
14 04 04 04 13 14 04 04 04 14 14 13 14 14 04 04 04 04 14 13 04 04 04 14 14
14 04 04 04 13 14 04 04 04 14 13 13 13 14 04 04 04 04 14 13 04 04 04 14 14
14 14 13 14 14 14 04 04 04 14 13 14 13 14 04 04 14 04 14 14 13 14 14 14 14
14 13 13 13 13 14 04 04 04 14 13 14 13 14 04 04 14 04 14 13 13 13 13 14 14
14 14 13 14 14 14 04 14 14 14 13 14 13 14 04 04 14 04 14 14 13 14 14 14 14
14 04 04 04 13 13 13 13 13 13 13 14 13 14 13 13 14 13 13 13 04 04 04 14 14
14 04 04 04 14 14 14 14 14 14 13 14 13 14 14 13 14 14 14 14 04 04 04 14 14
14 04 04 04 04 04 04 04 14 04 04 14 13 04 04 04 14 04 04 04 04 04 04 04 14
14 14 14 14 14 14 14 04 14 04 04 04 13 04 04 04 14 04 14 14 14 14 14 14 14
14 13 13 13 13 14 04 04 14 14 14 13 14 14 14 04 04 04 13 13 13 13 14 14 14
14 13 14 14 13 14 04 14 14 04 13 13 13 14 04 04 04 14 13 14 14 13 14 14 14
14 13 14 04 13 14 04 14 04 04 13 13 13 14 04 04 04 14 13 04 14 13 14 14 14
14 13 14 04 13 14 04 14 04 04 14 14 14 14 04 04 04 14 13 04 14 13 14 14 14
14 13 14 14 13 13 04 04 04 04 04 04 04 04 04 04 04 04 13 14 14 13 14 14 14
14 13 13 13 13 13 14 14 14 14 14 14 14 14 14 14 14 14 13 13 13 13 14 14 14
14 14 14 14 14 14 14 14 14 14 14 14 14 14 14 14 14 14 14 14 14 14 14 14 14