14 14 14 14 14 14 14 14 14 14 14 14 14 14 14 14 14 14 14 14 14 14 14 14 14
14 13 13 13 11 11 4 4 4 14 13 13 13 13 13 14 4 4 4 11 11 13 13 13 14
14 13 14 13 11 11 4 4 4 14 13 14 14 14 13 14 4 4 4 11 11 13 14 13 14
14 13 14 13 14 14 4 4 4 14 13 14 4 14 13 14 4 4 4 14 14 13 14 13 14
14 13 14 13 13 13 13 14 14 14 13 14 4 14 13 14 14 14 13 13 13 13 14 13 14
14 13 14 14 14 14 13 13 13 13 13 14 4 14 13 13 13 13 13 14 14 14 14 13 14
14 13 13 13 13 14 14 14 14 14 14 14 13 14 14 14 14 14 14 14 13 13 13 13 14
14 14 14 14 13 14 4 4 4 4 4 4 4 4 4 4 4 4 14 13 14 14 14 14 14
14 4 4 4 13 14 4 4 4 4 4 4 4 4 4 4 4 4 14 13 4 4 4 14 14
14 4 4 4 13 14 4 4 4 14 14 13 14 14 4 4 4 4 14 13 4 4 4 14 14
14 4 4 4 13 14 4 4 4 14 13 13 13 14 4 4 4 4 14 13 4 4 4 14 14
14 14 13 14 14 14 4 4 4 14 13 14 13 14 4 4 4 4 14 14 13 14 14 14 14
14 13 13 13 13 14 4 4 4 14 13 14 13 14 4 4 4 4 14 13 13 13 13 14 14
14 14 13 14 14 14 4 4 4 14 13 14 13 14 4 4 4 4 14 14 13 14 14 14 14
14 4 4 4 13 13 13 13 13 14 13 14 13 14 13 13 13 13 13 13 4 4 4 14 14
14 4 4 4 14 14 14 14 14 14 13 14 13 14 14 14 14 14 14 14 4 4 4 14 14
14 4 4 4 4 4 4 4 14 4 4 4 13 4 4 4 14 4 4 4 4 4 4 4 14
14 14 14 14 14 14 14 4 14 4 4 4 13 4 4 4 14 4 14 14 14 14 14 14 14
14 13 13 13 13 14 4 4 14 14 14 13 14 14 14 4 4 14 13 13 13 13 14 14 14
14 13 14 14 13 14 4 4 4 14 13 13 13 14 4 4 4 14 13 14 14 13 14 14 14
14 13 14 4 13 14 4 4 4 14 13 14 13 14 4 4 4 14 13 4 14 13 14 14 14
14 13 14 4 13 14 4 4 4 14 14 14 14 14 4 4 4 14 13 4 14 13 14 14 14
14 13 14 14 13 14 4 4 4 4 4 4 4 4 4 4 4 14 13 14 14 13 14 14 14
14 13 13 13 13 14 14 14 14 14 14 14 14 14 14 14 14 14 13 13 13 13 14 14 14
14 14 14 14 14 14 14 14 14 14 14 14 14 14 14 14 14 14 14 14 14 14 14 14 14