19 19 19 19 19 19 19 19 19 19 19 19 19 19 19 19
19 16 16 16 16 16 16 16 16 16 16 16 16 16 16 19
19 16 09 09 09 16 16 16 16 16 04 04 04 16 16 19
19 16 09 00 09 16 16 16 16 16 04 11 04 16 16 19
19 16 09 09 09 16 16 16 16 16 04 04 04 16 16 19
19 16 16 16 16 16 16 16 16 16 16 16 16 16 16 19
19 16 16 16 16 16 16 16 16 16 16 16 16 16 16 19
19 16 06 06 06 16 16 16 16 16 13 13 13 16 16 19
19 16 06 02 06 16 16 16 16 16 13 14 13 16 16 19
19 16 06 06 06 16 16 16 16 16 13 13 13 16 16 19
19 16 16 16 16 16 16 16 16 16 16 16 16 16 16 19
19 19 19 19 19 19 19 19 19 19 19 19 19 19 19 19