19 19 19 19 19 19 19 19 19 19 19 19 19 19 19 19 19 19 19 19 19 19 19 19 19 19 19 19 19 19 19 19 19 19 19 19 19 19 19 19 19 19 19 19 19 19 19 19 19 19
19 19 19 19 19 19 19 19 19 19 19 19 19 19 19 19 19 19 19 19 19 19 19 19 19 19 19 19 19 19 19 19 19 19 19 19 19 19 19 19 19 19 19 19 19 19 19 19 19 19
19 19 16 16 16 16 16 16 16 16 16 16 16 16 16 16 16 16 16 16 16 16 16 16 16 16 16 16 16 16 16 16 16 16 16 16 16 16 16 16 16 16 16 16 16 16 16 19 19 19
19 19 16 16 08 08 08 16 16 16 16 16 16 16 16 16 16 16 16 16 16 16 16 16 16 16 16 16 16 16 16 16 16 16 16 16 16 16 16 16 16 08 08 08 16 16 19 19 19 19
19 19 19 16 16 09 09 15 09 09 09 09 10 10 09 09 09 09 15 09 09 09 09 16 16 16 16 04 04 00 04 04 07 11 11 07 04 04 00 04 07 11 11 07 04 16 16 19 19 19
19 19 19 16 16 09 15 09 09 09 10 10 09 09 09 15 09 09 09 10 10 09 09 16 16 16 16 04 00 04 04 04 04 07 11 11 07 04 04 04 04 07 11 07 04 16 16 19 19 19
19 19 19 16 16 09 09 09 10 10 09 09 09 15 09 09 09 10 10 09 09 15 09 16 16 16 16 04 04 04 07 11 11 07 04 04 00 04 04 07 11 11 07 04 04 16 16 19 19 19
19 19 19 16 16 09 09 19 19 19 09 09 09 10 10 09 09 19 19 09 09 09 09 16 16 16 16 07 07 07 07 04 04 07 11 11 11 11 07 04 04 07 07 07 07 16 16 19 19 19
19 19 19 16 16 09 09 15 09 09 09 09 10 10 09 09 09 09 15 09 09 09 09 16 16 16 16 04 04 00 04 04 07 11 11 07 04 04 00 04 07 11 11 07 04 16 16 19 19 19
19 19 19 16 16 09 15 09 09 09 10 10 09 09 09 15 09 09 09 10 10 09 09 16 16 16 16 04 00 04 04 04 04 07 11 11 07 04 04 04 04 07 11 07 04 16 16 19 19 19
19 19 19 16 16 09 09 09 10 10 09 09 09 15 09 09 09 10 10 09 09 15 09 16 16 16 16 04 04 04 07 11 11 07 04 04 00 04 04 07 11 11 07 04 04 16 16 19 19 19
19 19 19 16 16 09 09 09 09 09 09 15 09 09 09 09 09 09 09 09 09 09 09 16 16 16 16 04 04 04 04 04 04 04 00 04 04 04 04 04 04 04 04 04 00 16 16 19 19 19
19 19 19 16 16 09 09 15 09 09 09 09 10 10 09 09 09 09 15 09 09 09 09 16 16 16 16 04 04 00 04 04 07 11 11 07 04 04 00 04 07 11 11 07 04 16 16 19 19 19
19 19 19 16 16 09 15 09 09 09 10 10 09 09 09 15 09 09 09 10 10 09 09 16 16 16 16 04 00 04 04 04 04 07 11 11 07 04 04 04 04 07 11 07 04 16 16 19 19 19
19 19 19 16 16 09 09 09 10 10 09 09 09 15 09 09 09 10 10 09 09 15 09 16 16 16 16 04 04 04 07 11 11 07 04 04 00 04 04 07 11 11 07 04 04 16 16 19 19 19
19 19 19 16 16 09 09 19 19 19 09 09 09 10 10 09 09 19 19 09 09 09 09 16 16 16 16 07 07 07 07 04 04 07 11 11 11 11 07 04 04 07 07 07 07 16 16 19 19 19
19 19 19 16 16 09 09 15 09 09 09 09 10 10 09 09 09 09 15 09 09 09 09 16 16 16 16 04 04 00 04 04 07 11 11 07 04 04 00 04 07 11 11 07 04 16 16 19 19 19
19 19 19 16 16 09 15 09 09 09 10 10 09 09 09 15 09 09 09 10 10 09 09 16 16 16 16 04 00 04 04 04 04 07 11 11 07 04 04 04 04 07 11 07 04 16 16 19 19 19
19 19 19 16 16 09 09 09 10 10 09 09 09 15 09 09 09 10 10 09 09 15 09 16 16 16 16 04 04 04 07 11 11 07 04 04 00 04 04 07 11 11 07 04 04 16 16 19 19 19
19 19 19 16 16 09 09 09 09 09 09 15 09 09 09 09 09 09 09 09 09 09 09 16 16 16 16 04 04 04 04 04 04 04 00 04 04 04 04 04 04 04 04 04 00 16 16 19 19 19
19 19 19 16 16 09 09 15 09 09 09 09 10 10 09 09 09 09 15 09 09 09 09 16 16 16 16 04 04 00 04 04 07 11 11 07 04 04 00 04 07 11 11 07 04 16 16 19 19 19
19 19 19 16 16 16 16 16 16 16 16 16 10 10 16 16 16 16 16 16 16 16 16 16 16 16 16 16 16 16 16 16 16 16 16 16 16 16 16 16 16 16 16 16 16 16 16 19 19 19
19 19 19 16 16 08 08 08 08 08 16 16 10 10 16 16 08 08 08 08 16 16 16 16 16 16 16 16 08 08 08 08 16 16 04 04 16 16 08 08 08 08 08 16 16 16 16 19 19 19
19 19 19 16 16 08 08 08 08 08 16 16 10 10 16 16 08 08 08 08 16 16 01 01 01 01 16 16 08 08 08 08 16 16 04 04 16 16 08 08 08 08 08 16 16 16 16 19 19 19
19 19 19 16 16 16 16 16 16 16 16 16 01 01 16 16 16 16 16 16 16 01 01 05 05 01 01 16 16 16 16 16 16 16 01 01 16 16 16 16 16 16 16 16 16 16 16 19 19 19
19 19 19 16 16 16 16 16 16 16 16 16 01 01 16 16 16 16 16 16 16 01 01 05 05 01 01 16 16 16 16 16 16 16 01 01 16 16 16 16 16 16 16 16 16 16 16 19 19 19
19 19 19 16 16 08 08 08 08 08 16 16 01 01 16 16 08 08 08 08 16 16 01 01 01 01 16 16 08 08 08 08 16 16 01 01 16 16 08 08 08 08 08 16 16 16 16 19 19 19
19 19 19 16 16 08 08 08 08 08 16 16 01 01 16 16 08 08 08 08 16 16 16 16 16 16 16 16 08 08 08 08 16 16 01 01 16 16 08 08 08 08 08 16 16 16 16 19 19 19
19 19 19 16 16 06 12 06 02 02 06 17 01 01 17 06 06 03 03 06 05 06 06 16 16 16 16 13 13 13 13 14 14 14 01 01 14 13 13 13 13 13 13 13 13 16 16 19 19 19
19 19 19 16 16 06 06 05 06 06 12 06 01 01 06 17 18 18 17 06 06 03 03 16 16 16 16 13 14 14 13 14 13 13 01 01 14 13 14 14 14 14 14 14 13 16 16 19 19 19
19 19 19 16 16 03 03 06 06 05 06 06 01 01 06 02 02 06 17 18 18 17 06 16 16 16 16 13 14 13 13 14 13 14 14 13 14 13 14 13 13 13 13 14 13 16 16 19 19 19
19 19 19 16 16 06 06 03 03 06 06 05 01 01 12 06 02 02 06 17 18 18 17 16 16 16 16 13 14 14 14 14 13 14 14 13 14 13 14 13 14 14 13 14 13 16 16 19 19 19
19 19 19 16 16 06 12 06 02 02 06 17 18 18 17 06 06 03 03 06 05 06 06 16 16 16 16 13 13 13 13 14 14 14 14 14 14 13 13 13 13 13 13 13 13 16 16 19 19 19
19 19 19 16 16 06 06 05 06 06 12 06 02 02 06 17 18 18 17 06 06 03 03 16 16 16 16 13 14 14 13 14 13 13 13 13 14 13 14 14 14 14 14 14 13 16 16 19 19 19
19 19 19 16 16 03 03 06 06 05 06 06 12 06 02 02 06 17 18 18 17 06 06 16 16 16 16 13 14 13 13 14 13 14 14 13 14 13 14 13 13 13 13 14 13 16 16 19 19 19
19 19 19 16 16 06 06 06 01 01 06 06 06 06 06 06 01 01 06 06 06 06 06 16 16 16 16 13 13 13 01 01 13 13 13 13 13 13 01 01 13 13 13 13 13 16 16 19 19 19
19 19 19 16 16 06 12 06 02 02 06 17 18 18 17 06 06 03 03 06 05 06 06 16 16 16 16 13 13 13 13 14 14 14 14 14 14 13 13 13 13 13 13 13 13 16 16 19 19 19
19 19 19 16 16 06 06 05 06 06 12 06 02 02 06 17 18 18 17 06 06 03 03 16 16 16 16 13 14 14 13 14 13 13 13 13 14 13 14 14 14 14 14 14 13 16 16 19 19 19
19 19 19 16 16 03 03 06 06 05 06 06 12 06 02 02 06 17 18 18 17 06 06 16 16 16 16 13 14 13 13 14 13 14 14 13 14 13 14 13 13 13 13 14 13 16 16 19 19 19
19 19 19 16 16 06 06 03 03 06 06 05 06 06 12 06 02 02 06 17 18 18 17 16 16 16 16 13 14 14 14 14 13 14 14 13 14 13 14 13 14 14 13 14 13 16 16 19 19 19
19 19 19 16 16 06 12 06 02 02 06 17 18 18 17 06 06 03 03 06 05 06 06 16 16 16 16 13 13 13 13 14 14 14 14 14 14 13 13 13 13 13 13 13 13 16 16 19 19 19
19 19 19 16 16 06 06 05 06 06 12 06 02 02 06 17 18 18 17 06 06 03 03 16 16 16 16 13 14 14 13 14 13 13 13 13 14 13 14 14 14 14 14 14 13 16 16 19 19 19
19 19 19 16 16 03 03 06 06 05 06 06 12 06 02 02 06 17 18 18 17 06 06 16 16 16 16 13 14 13 13 14 13 14 14 13 14 13 14 13 13 13 13 14 13 16 16 19 19 19
19 19 19 16 16 06 06 06 01 01 06 06 06 06 06 06 01 01 06 06 06 06 06 16 16 16 16 13 13 13 01 01 13 13 13 13 13 13 01 01 13 13 13 13 13 16 16 19 19 19
19 19 19 16 16 06 12 06 02 02 06 17 18 18 17 06 06 03 03 06 05 06 06 16 16 16 16 13 13 13 13 14 14 14 14 14 14 13 13 13 13 13 13 13 13 16 16 19 19 19
19 19 19 16 16 16 16 16 16 16 16 16 16 16 16 16 16 16 16 16 16 16 16 16 16 16 16 16 16 16 16 16 16 16 16 16 16 16 16 16 16 16 16 16 16 16 16 19 19 19
19 19 19 16 16 08 08 08 16 16 16 16 16 16 16 16 16 16 16 16 16 16 16 16 16 16 16 16 16 16 16 16 16 16 16 16 16 16 16 16 16 08 08 08 16 16 19 19 19 19
19 19 19 19 16 16 16 16 16 16 16 16 16 16 16 16 16 16 16 16 16 16 16 16 16 16 16 16 16 16 16 16 16 16 16 16 16 16 16 16 16 16 16 16 16 16 19 19 19 19
19 19 19 19 19 19 19 19 19 19 19 19 19 19 19 19 19 19 19 19 19 19 19 19 19 19 19 19 19 19 19 19 19 19 19 19 19 19 19 19 19 19 19 19 19 19 19 19 19 19
19 19 19 19 19 19 19 19 19 19 19 19 19 19 19 19 19 19 19 19 19 19 19 19 19 19 19 19 19 19 19 19 19 19 19 19 19 19 19 19 19 19 19 19 19 19 19 19 19 19