07 07 07 07 07 07 07 07 07 07 07 07 07 07 07 07 07 07 07 07 07 07 07 07 07
07 01 01 01 15 04 04 04 04 04 15 01 01 01 15 04 04 04 15 01 01 01 04 04 07
07 01 01 01 15 04 15 15 15 04 15 01 01 01 15 15 15 04 15 01 01 01 15 04 07
07 01 01 01 04 04 04 04 15 04 04 04 04 04 15 04 04 04 15 01 01 01 15 04 07
07 15 15 15 15 15 15 04 15 15 15 15 15 04 15 04 15 15 15 15 15 15 15 04 07
07 04 04 04 04 04 15 04 15 04 04 04 15 04 15 04 15 04 04 04 04 04 15 04 07
07 04 15 15 15 04 15 04 15 04 15 04 15 04 15 04 15 04 15 15 15 04 15 04 07
07 04 15 01 01 04 04 04 15 04 15 04 04 04 04 04 04 04 01 01 15 04 04 04 07
07 04 15 01 01 15 15 15 15 04 15 15 15 15 15 15 15 15 01 01 15 15 15 04 07
07 04 15 01 01 04 04 04 04 04 04 04 04 04 04 04 04 04 01 01 04 04 04 04 07
07 04 15 15 15 15 15 04 15 15 15 15 15 04 15 15 15 15 15 15 15 15 15 04 07
07 04 04 04 04 04 15 04 15 01 01 01 15 04 15 01 01 01 15 04 04 04 15 04 07
07 15 15 15 15 04 15 04 15 01 01 01 15 04 15 01 01 01 15 04 15 04 15 04 07
07 04 04 04 15 04 15 04 15 01 01 01 04 04 04 01 01 01 15 04 15 04 15 04 07
07 04 15 04 15 04 15 04 15 15 15 15 15 15 15 15 15 15 15 04 15 04 15 04 07
07 04 15 04 04 04 15 04 04 04 04 04 04 04 04 04 04 04 04 04 15 04 04 04 07
07 04 15 15 15 15 15 15 15 15 15 04 15 15 15 15 15 15 15 15 15 15 15 04 07
07 04 04 04 04 04 04 04 04 15 01 01 01 15 04 04 04 04 04 04 04 04 15 04 07
07 15 15 15 15 15 15 15 04 15 01 01 01 15 04 15 15 15 15 15 15 04 15 04 07
07 01 01 01 04 04 04 15 04 15 01 01 01 15 04 15 01 01 01 04 04 04 15 04 07
07 01 01 01 15 15 04 15 04 15 15 15 15 15 04 15 01 01 01 15 15 15 15 04 07
07 01 01 01 15 04 04 15 04 04 04 04 04 04 04 15 01 01 01 15 04 04 04 04 07
07 15 15 15 15 04 15 15 15 15 15 15 15 15 15 15 15 15 15 15 04 15 15 15 07
07 04 04 04 04 04 04 04 04 04 04 04 04 04 04 04 04 04 04 04 04 04 04 04 07
07 07 07 07 07 07 07 07 07 07 07 07 07 07 07 07 07 07 07 07 07 07 07 07 07