8 8 8 8 8 8 8 8 8 8 8 8 8 8 8 8 8 8 8 8 8 8 8 8 8
8 1 1 1 8 16 16 16 16 16 8 1 1 1 8 16 16 16 8 1 1 1 16 16 8
8 1 1 1 8 16 8 8 8 16 8 1 1 1 8 8 8 16 8 1 1 1 8 16 8
8 1 1 1 16 16 16 16 8 16 16 16 16 16 8 16 16 16 8 1 1 1 8 16 8
8 8 8 8 8 8 8 16 8 8 8 8 8 16 8 16 8 8 8 8 8 8 8 16 8
8 16 16 16 16 16 8 16 8 16 16 16 8 16 8 16 8 16 16 16 16 16 8 16 8
8 16 8 8 8 16 8 16 8 16 8 16 8 16 8 16 8 16 8 8 8 16 8 16 8
8 16 8 1 1 16 16 16 8 16 8 16 16 16 16 16 16 16 1 1 8 16 16 16 8
8 16 8 1 1 8 8 8 8 16 8 8 8 8 8 8 8 8 1 1 8 8 8 16 8
8 16 8 1 1 16 16 16 16 16 16 16 16 16 16 16 16 16 1 1 16 16 16 16 8
8 16 8 8 8 8 8 16 8 8 8 8 8 16 8 8 8 8 8 8 8 8 8 16 8
8 16 16 16 16 16 8 16 8 1 1 1 8 16 8 1 1 1 8 16 16 16 8 16 8
8 8 8 8 8 16 8 16 8 1 1 1 8 16 8 1 1 1 8 16 8 16 8 16 8
8 16 16 16 8 16 8 16 8 1 1 1 16 16 16 1 1 1 8 16 8 16 8 16 8
8 16 8 16 8 16 8 16 8 8 8 8 8 8 8 8 8 8 8 16 8 16 8 16 8
8 16 8 16 16 16 8 16 16 16 16 16 16 16 16 16 16 16 16 16 8 16 16 16 8
8 16 8 8 8 8 8 8 8 8 8 16 8 8 8 8 8 8 8 8 8 8 8 16 8
8 16 16 16 16 16 16 16 16 8 1 1 1 8 16 16 16 16 16 16 16 16 8 16 8
8 8 8 8 8 8 8 8 16 8 1 1 1 8 16 8 8 8 8 8 8 16 8 16 8
8 1 1 1 16 16 16 8 16 8 1 1 1 8 16 8 1 1 1 16 16 16 8 16 8
8 1 1 1 8 8 16 8 16 8 8 8 8 8 16 8 1 1 1 8 8 8 8 16 8
8 1 1 1 8 16 16 8 16 16 16 16 16 16 16 8 1 1 1 8 16 16 16 16 8
8 8 8 8 8 16 8 8 8 8 8 8 8 8 8 8 8 8 8 8 16 8 8 8 8
8 16 16 16 16 16 16 16 16 16 16 16 16 16 16 16 16 16 16 16 16 16 16 16 8
8 8 8 8 8 8 8 8 8 8 8 8 8 8 8 8 8 8 8 8 8 8 8 8 8