19 19 19 19 19 19 19 19 19 19 19 19 19 19 19 19 19 19 19 19 19 19 19 19 19
19 10 10 10 0 9 9 9 9 9 0 10 10 10 0 9 9 9 0 10 10 10 9 9 19
19 10 10 10 0 9 0 0 0 9 0 10 10 10 0 0 0 9 0 10 10 10 0 9 19
19 10 10 10 9 9 9 9 0 9 9 9 9 9 0 9 9 9 0 10 10 10 0 9 19
19 0 0 0 0 0 0 9 0 0 0 0 0 9 0 9 0 0 0 0 0 0 0 9 19
19 9 9 9 9 9 0 9 0 9 9 9 0 9 0 9 0 9 9 9 9 9 0 9 19
19 9 0 0 0 9 0 9 0 9 0 9 0 9 0 9 0 9 0 0 0 9 0 9 19
19 9 0 10 10 9 9 9 0 9 0 9 9 9 9 9 9 9 10 10 0 9 9 9 19
19 9 0 10 10 0 0 0 0 9 0 0 0 0 0 0 0 0 10 10 0 0 0 9 19
19 9 0 10 10 9 9 9 9 9 9 9 9 9 9 9 9 9 10 10 9 9 9 9 19
19 9 0 0 0 0 0 9 0 0 0 0 0 9 0 0 0 0 0 0 0 0 0 9 19
19 9 9 9 9 9 0 9 0 10 10 10 0 9 0 10 10 10 0 9 9 9 0 9 19
19 0 0 0 0 9 0 9 0