7 7 7 7 7 7 7 7 7 7 7 7 7 7 7 7 7 7 7 7 7 7 7 7 7
7 1 1 1 15 4 4 4 4 4 15 1 1 1 15 4 4 4 15 1 1 1 4 4 7
7 1 1 1 15 4 15 15 15 4 15 1 1 1 15 15 15 4 15 1 1 1 15 4 7
7 1 1 1 4 4 4 4 15 4 4 4 4 4 15 4 4 4 15 1 1 1 15 4 7
7 15 15 15 15 15 15 4 15 15 15 15 15 4 15 4 15 15 15 15 15 15 15 4 7
7 4 4 4 4 4 15 4 15 4 4 4 15 4 15 4 15 4 4 4 4 4 15 4 7
7 4 15 15 15 4 15 4 15 4 15 4 15 4 15 4 15 4 15 15 15 4 15 4 7
7 4 15 1 1 4 4 4 15 4 15 4 4 4 4 4 4 4 1 1 15 4 4 4 7
7 4 15 1 1 15 15 15 15 4 15 15 15 15 15 15 15 15 1 1 15 15 15 4 7
7 4 15 1 1 4 4 4 4 4 4 4 4 4 4 4 4 4 1 1 4 4 4 4 7
7 4 15 15 15 15 15 4 15 15 15 15 15 4 15 15 15 15 15 15 15 15 15 4 7
7 4 4 4 4 4 15 4 15 1 1 1 15 4 15 1 1 1 15 4 4 4 15 4 7
7 15 15 15 15 4 15 4 15 1 1 1 15 4 15 1 1 1 15 4 15 4 15 4 7
7 4 4 4 15 4 15 4 15 1 1 1 4 4 4 1 1 1 15 4 15 4 15 4 7
7 4 15 4 15 4 15 4 15 15 15 15 15 15 15 15 15 15 15 4 15 4 15 4 7
7 4 15 4 4 4 15 4 4 4 4 4 4 4 4 4 4 4 4 4 15 4 4 4 7
7 4 15 15 15 15 15 15 15 15 15 4 15 15 15 15 15 15 15 15 15 15 15 4 7
7 4 4 4 4 4 4 4 4 15 1 1 1 15 4 4 4 4 4 4 4 4 15 4 7
7 15 15 15 15 15 15 15 4 15 1 1 1 15 4 15 15 15 15 15 15 4 15 4 7
7 1 1 1 4 4 4 15 4 15 1 1 1 15 4 15 1 1 1 4 4 4 15 4 7
7 1 1 1 15 15 4 15 4 15 15 15 15 15 4 15 1 1 1 15 15 15 15 4 7
7 1 1 1 15 4 4 15 4 4 4 4 4 4 4 15 1 1 1 15 4 4 4 4 7
7 15 15 15 15 4 15 15 15 15 15 15 15 15 15 15 15 15 15 15 4 15 15 15 7
7 4 4 4 4 4 4 4 4 4 4 4 4 4 4 4 4 4 4 4 4 4 4 4 7
7 7 7 7 7 7 7 7 7 7 7 7 7 7 7 7 7 7 7 7 7 7 7 7 7